#....####
#.#......
..#..#GB.
.....b#..
..##....#
......#..
#g.......
##.S..###
