#....###
#......#
#..#...#
...G....
..gWG#..
..#g....
.w.....#
#...S..#
